Pronoun
	u-Person
		u-0	(Zero person)
		u-1	(First person)
		u-2	(Second person)
		u-3	(Third person)
		u-4	(Fourth person)
		u-excl	(Exclusive)
		u-incl	(Inclusive)
		u-obv	(Obviative)
		u-prx	(Proximate)
	u-Gender
		u-bantu1-23	(Bantu Noun Classes)
		u-fem	(Feminine)
		u-masc	(Masculine)
		u-nakh1-8	(Nakh-Daghestanian Noun Classes)
		u-neut	(Neuter)
	u-Number
		u-du	(Dual)
		u-gpauc	(Greater paucal)
		u-grpl	(Greater plural)
		u-invn	(Inverse)
		u-pauc	(Paucal)
		u-pl	(Plural)
		u-sg	(Singular)
		u-tri	(Trial)
	u-Case
		u-abl	(Ablative)
		u-abs	(Absolutive)
		u-acc	(Accusative)
		u-all	(Allative)
		u-ante	(Near, in front of)
		u-apprx	(Approximative)
		u-apud	(Next to)
		u-at	(At)
		u-avr	(Aversive)
		u-ben	(Benefactive)
		u-byway	(Essive-modal)
		u-circ	(Near)
		u-com	(Comitative)
		u-compv	(Comparative)
		u-dat	(Dative)
		u-eqtv	(Equative)
		u-erg	(Ergative)
		u-ess	(Essive)
		u-frml	(Formal)
		u-gen	(Genitive)
		u-in	(In)
		u-ins	(Instrumental)
		u-inter	(Among)
		u-nom	(Nominative)
		u-noms	(Nominative, S-only)
		u-on	(On)
		u-onhr	(On (horizontal))
		u-onvr	(On (vertical))
		u-post	(Behind)
		u-priv	(Privative)
		u-prol	(Prolative/translative)
		u-propr	(Proprietive)
		u-prox	(Proximate)
		u-prp	(Purposive)
		u-prt	(Partitive)
		u-rel	(Relative)
		u-rem	(Distal)
		u-sub	(Under)
		u-term	(Terminative)
		u-trans	(Translative)
		u-vers	(Versative)
		u-voc	(Vocative)
	u-Deixis
		u-abv	(Above)
		u-bel	(Below)
		u-even	(Even)
		u-med	(Medial)
		u-noref	(No Reference Point, Distal)
		u-nvis	(Invisible)
		u-phor	(Phoric, situated in discourse)
		u-prox	(Proximate)
		u-ref1	(First Person Reference Point)
		u-ref2	(Second Person Reference Point)
		u-remt	(Remote)
		u-vis	(Visible)
	x-Pronoun-type
		x-pers
		x-refl
		x-dem
		x-poss
		x-int
		x-rel
