Conditionals
	u-Tense
		u-1day	(Within 1 day)
		u-fut	(Future)
		u-hod	(Hodiernal)
		u-immed	(Immediate)
		u-prs	(Present)
		u-pst	(Past)
		u-rct	(Recent)
		u-rmt	(Remote)
	u-Mood
		u-adm	(Admirative)
		u-aunprp	(Australian Non-Purposive)
		u-auprp	(Australian Purposive)
		u-cond	(Conditional)
		u-deb	(Debitive)
		u-ded	(Deductive)
		u-imp	(Imperative-Jussive)
		u-ind	(Indicative)
		u-inten	(Intentive)
		u-irr	(Irrealis)
		u-lkly	(Likely)
		u-oblig	(Obligative)
		u-opt	(Optative-Desiderative)
		u-perm	(Permissive)
		u-pot	(Potential)
		u-purp	(General Purposive)
		u-real	(Realis)
		u-sbjv	(Subjunctive)
		u-sim	(Simulative)
